#######
#..S..#
###.#.#
#.....#
#.###E#
#######