#######
#S....#
###.#.#
#.....#
#.###E#
#######